            ###########                        #########                        
            #.........#                        #.......#                        
            #.........#             ############.......#                        
            #.........###############..........#.......##############           
            #.........#.............+..........#.......+............#           
            #.........+.............#..........#.......#............e           
      ########+########.............#..........+.......#............#           
      #.........#     #.............####+#######.......#............#           
      #.........#     #.............##.........######################           
      #.........#     #####+##########.........#              ###########       
      #.........#       #......#     #.........#              #.........#       
      ########+##########......#     #.........#              #.........#       
           #...........##......#     #.........#              #.........#       
           #...........##......#     #.........#              #.........#       
           #...........##......#     #.........#  ################+######       
           #...........##......#     #.........#  #.......+.........############
           #...........##......#  ########+########.......#.........#..........#
           #...........##......#  #...............#.......#.........#..........#
           #...........#########  #...............#.......#.........#..........#
           #...........#          #.......s.......#.......#.........+..........#
           #####+#######          #...............+.......#.........#..........#
           #.........#            #...............###################..........#
           #.........############ #...............#                 #..........#
           #.........#..........# #...............#                 ############
           #.........#..........#####+###########+#############                 
    ########+#########..........+........#      #.............#                 
    #........#       #..........#........#      #.............#########         
    #........#  ######+##########........#      #.............#.......#         
    #........#  #..........#    #........#      #.............+.......#         
    #........#  #..........#    #........#      #.............#.......#         
    #........#  #..........#    #........#      #.............#.......#         
    #........#  #..........#    #........#      #.............#.......#         
    #........#  #..........#########+#####      #.............#.......#         
    #...k....#  #..........#.........#  ##########+############+#######         
    #........#  #..........#.........#  #..............#   #..........#         
    ##########  #..........#.........#  #..............#   #..........#         
                ############.........#  #..............#   #..........#         
                           #.........#  #..............#   #..........#         
                           ###########  #..............#   #..........#         
                                        ################   ############         